177,178,178,178,178,178,178,178,178,178,178,178,178,178,178,178,178,178,178,178,178,178,178,178,178,178,178,178,179,
198,199,199,199,199,199,199,199,199,199,199,199,199,199,199,199,199,199,199,199,199,199,199,199,199,199,199,199,200,
198,199,199,199,199,199,199,199,199,439,199,199,199,199,199,199,199,199,199,199,199,199,199,199,199,199,199,199,200,
198,199,199,199,199,199,199,199,199,199,199,199,199,199,199,199,199,199,199,199,199,199,199,199,199,199,199,199,200,
198,199,199,199,199,199,199,199,199,199,199,199,199,571,199,199,199,199,199,199,199,199,199,199,199,199,199,199,200,
198,199,199,199,199,199,199,199,199,199,199,199,199,592,199,199,199,199,199,199,199,199,199,199,199,199,199,199,200,
198,199,199,199,199,199,199,199,199,199,199,199,199,613,199,199,199,199,199,199,199,199,199,199,199,199,199,199,200,
198,199,199,199,199,199,199,199,199,199,199,199,199,199,199,199,199,199,199,199,199,199,199,199,199,199,199,199,200,
198,199,199,199,199,199,199,199,199,199,199,199,199,199,199,199,199,199,199,199,199,199,199,199,199,199,199,199,200,
198,199,199,199,199,199,199,199,199,439,199,199,199,199,199,199,199,199,199,199,199,199,199,199,199,199,199,199,200,
198,199,199,199,199,199,199,199,199,199,199,199,199,199,199,199,199,199,199,199,199,199,199,199,199,199,199,199,200,
198,199,199,199,199,199,199,199,199,199,199,199,199,199,199,199,199,199,199,199,199,199,199,199,199,199,199,199,200,
198,199,199,199,199,199,199,199,199,199,199,199,199,199,199,199,199,199,199,199,199,199,199,199,199,199,199,199,200,
219,220,220,220,220,220,220,220,220,220,220,220,220,220,220,220,220,220,220,220,220,220,220,220,220,220,220,220,221,
177,178,178,178,178,178,178,178,178,178,178,178,178,178,178,178,178,178,178,178,178,178,178,178,178,178,178,178,179,
198,199,199,199,199,199,199,199,199,199,199,199,199,199,199,199,199,199,199,199,199,199,199,199,199,199,199,199,200,
198,199,199,199,199,199,199,199,199,439,199,199,199,199,199,199,199,199,199,199,199,199,199,199,199,199,199,199,200,
198,199,199,199,199,199,199,199,199,199,199,199,199,199,199,199,199,199,199,199,199,199,199,199,199,199,199,199,200,
198,199,199,199,199,199,199,199,199,199,199,199,199,571,199,199,199,199,199,199,199,199,199,199,199,199,199,199,200,
198,199,199,199,199,199,199,199,199,199,199,199,199,592,199,199,199,199,199,199,199,199,199,199,199,199,199,199,200,
198,199,199,199,199,199,199,199,199,199,199,199,199,613,199,199,199,199,199,199,199,199,199,199,199,199,199,199,200,
198,199,199,199,199,199,199,199,199,199,199,199,199,199,199,199,199,199,199,199,199,199,199,199,199,199,199,199,200,
198,199,199,199,199,199,199,199,199,199,199,199,199,199,199,199,199,199,199,199,199,199,199,199,199,199,199,199,200,
198,199,199,199,199,199,199,199,199,439,199,199,199,199,199,199,199,199,199,199,199,199,199,199,199,199,199,199,200,
198,199,199,199,199,199,199,199,199,199,199,199,199,199,199,199,199,199,199,199,199,199,199,199,199,199,199,199,200,
198,199,199,199,199,199,199,199,199,199,199,199,199,199,199,199,199,199,199,199,199,199,199,199,199,199,199,199,200,
198,199,199,199,199,199,199,199,199,199,199,199,199,199,199,199,199,199,199,199,199,199,199,199,199,199,199,199,200,
219,220,220,220,220,220,220,220,220,220,220,220,220,220,220,220,220,220,220,220,220,220,220,220,220,220,220,220,221,
177,178,178,178,178,178,178,178,178,178,178,178,178,178,178,178,178,178,178,178,178,178,178,178,178,178,178,178,179,
198,199,199,199,199,199,199,199,199,199,199,199,199,199,199,199,199,199,199,199,199,199,199,199,199,199,199,199,200,
198,199,199,199,199,199,199,199,199,439,199,199,199,199,199,199,199,199,199,199,199,199,199,199,199,199,199,199,200,
198,199,199,199,199,199,199,199,199,199,199,199,199,199,199,199,199,199,199,199,199,199,199,199,199,199,199,199,200,
198,199,199,199,199,199,199,199,199,199,199,199,199,571,199,199,199,199,199,199,199,199,199,199,199,199,199,199,200,
198,199,199,199,199,199,199,199,199,199,199,199,199,592,199,199,199,199,199,199,199,199,199,199,199,199,199,199,200,
198,199,199,199,199,199,199,199,199,199,199,199,199,613,199,199,199,199,199,199,199,199,199,199,199,199,199,199,200,
198,199,199,199,199,199,199,199,199,199,199,199,199,199,199,199,199,199,199,199,199,199,199,199,199,199,199,199,200,
198,199,199,199,199,199,199,199,199,199,199,199,199,199,199,199,199,199,199,199,199,199,199,199,199,199,199,199,200,
198,199,199,199,199,199,199,199,199,439,199,199,199,199,199,199,199,199,199,199,199,199,199,199,199,199,199,199,200,
198,199,199,199,199,199,199,199,199,199,199,199,199,199,199,199,199,199,199,199,199,199,199,199,199,199,199,199,200,
198,199,199,199,199,199,199,199,199,199,199,199,199,199,199,199,199,199,199,199,199,199,199,199,199,199,199,199,200,
198,199,199,199,199,199,199,199,199,199,199,199,199,199,199,199,199,199,199,199,199,199,199,199,199,199,199,199,200,
219,220,220,220,220,220,220,220,220,220,220,220,220,220,220,220,220,220,220,220,220,220,220,220,220,220,220,220,221




