177,178,178,178,178,178,178,178,178,178,178,178,
198,199,199,199,199,199,199,199,199,199,199,199,
198,199,199,199,199,199,199,199,199,439,199,199,
198,199,199,199,199,199,199,199,199,199,199,199,
198,199,199,199,199,199,199,199,199,199,199,199,
198,199,199,199,199,199,199,199,199,199,199,199,
198,199,199,199,199,199,199,199,199,199,199,199,
198,199,199,199,199,199,199,199,199,199,199,199,
198,199,199,199,199,199,199,199,199,199,199,199,
198,199,199,199,199,199,199,199,199,439,199,199,
198,199,199,199,199,199,199,199,199,199,199,199,
198,199,199,199,199,199,199,199,199,199,199,199,
198,199,199,199,199,199,199,199,199,199,199,199,
219,220,220,220,220,220,220,220,220,220,220,220
